spcID	IUCN
Acacia_baileyana	NE
Acacia_cyclops	NE
Acacia_dealbata	NE
Acacia_elata	NE
Acacia_implexa	NE
Acacia_karroo	LC
Acacia_longifolia	NE
Acacia_mearnsii	NE
Acacia_melanoxylon	NE
Acacia_paradoxa	NA
Acacia_podalyriifolia	NE
Acacia_pycnantha	NE
Acacia_saligna	NE
Acacia_subporosa	NE
Acacia_viscidula	NE
Acanthus_mollis	NA
Acer_negundo	NA
Achyranthes_aspera	NE
Acroceras_macrum	LC
Acrolophia_bolusii	VU
Acrolophia_capensis	LC
Acrolophia_lamellata	LC
Acrolophia_ustulata	VU
Acrosanthes_teretifolia	LC
Adenandra_uniflora	LC
Adenandra_villosa	Rare
Adenocline_pauciflora	LC
Adenocline_violaefolia	NA
Adenogramma_glomerata	LC
Adenogramma_lichtensteiniana	LC
Adenogramma_mollugo	LC
Adenogramma_rigida	CR_PE
Adiantum_aethiopicum	LC
Adiantum_capillis_-_veneris	NA
Adiantum_hispidulum	LC
Adiantum_poiretii	LC
Adiantum_raddianum	NE
Adromischus_hemisphaericus	LC
Afrocarpus_falcatus	LC
Agapanthus_africanus	LC
Agapanthus_preacox	NA
Agathelpis_dubia	LC
Agathelpis_nitida	Rare
Agathosma_bifida	LC
Agathosma_capensis	LC
Agathosma_ciliaris	LC
Agathosma_ciliata	LC
Agathosma_corymbosa	EN
Agathosma_glabrata	EN
Agathosma_hookeri	Rare
Agathosma_imbricata	LC
Agathosma_lanceolata	LC
Agathosma_pulchella	VU
Agathosma_serpyllacea	LC
Agathosma_tabularis	LC
Agave_americana	NE
Agave_sisalana	NE
Ageratina_adenophora	NE
Agrostis_avenacea	NE
Agrostis_bergiana	LC
Agrostis_lachnantha	LC
Agrostis_polypogonoides	LC
Ailanthus_altissima	NA
Aira_cupaniana	NE
Aizoon_paniculatum	LC
Aizoon_sarmentosum	LC
Albuca_canadensis	LC
Albuca_cooperi	LC
Albuca_flaccida	LC
Albuca_fragrans	LC
Albuca_imbricata	LC
Albuca_juncifolia	LC
Albuca_spiralis	LC
Alchemilla_capensis	LC
Alciope_tabularis	LC
Alectra_lurida	LC
Alectra_sessiliflora	LC
Alisma_plantago_-_aquatica	NA
Alnus_glutinosa	NA
Aloe_arborescens	LC
Aloe_commixta	VU
Aloe_maculata	LC
Aloe_succotrina	LC
Alternanthera_pungens	NE
Althenia_filiformis	LC
Amaranthus_deflexus	NE
Amaranthus_hybridus	NE
Amaranthus_lividus	NA
Amaranthus_muricatus	NE
Amaranthus_sicula	NA
Amaranthus_thunbergii	LC
Amaryllis_belladona	NA
Amauropelta_bergiana	LC
Ambrosia_artemisifolia	NA
Amellus_asteroides	LC
Amellus_capensis	VU
Ammi_majus	NA
Ammocharis_longifolia	LC
Ammophila_arenaria	NE
Amphithalea_ericifolia	CR
Amphithalia_imbricata	NA
Amsinckia_calycina	NE
Anagallis_arvensis	NE
Anagallis_foemina	NA
Anaxeton_arborescens	LC
Anaxeton_asperum	LC
Anaxeton_laeve	LC
Anaxeton_nycthemerum	LC
Androcymbium_capense	LC
Androcymbium_eucomoides	LC
Andropogon_eucomis	NA
Anemone_tenuifolia	LC
Anisodontea_biflora	LC
Anisodontea_scabrosa	LC
Annesorhiza_altiscapa	LC
Annesorhiza_hirsuta	LC
Annesorhiza_macrocarpa	LC
Annesorhiza_nuda	LC
Anogramma_leptophylla	LC
Anomatheca_fistulosa	LC
Anredera_cordifolia	NE
Anthemis_cotula	NE
Anthochortus_capensis	Rare
Anthochortus_crinalis	LC
Anthochortus_laxiflorus	LC
Anthospermum_aethiopicum	LC
Anthospermum_bergianum	LC
Anthospermum_galioides	LC
Anthospermum_hirtum	LC
Anthospermum_prostratum	LC
Anthospermum_spathulatum	LC
Anthoxanthum_dregeanum	LC
Anthoxanthum_odoratum	NE
Anthoxanthum_tongo	LC
Antimima_promontorii	NA
Antirrhinum_orantium	NA
Apatesia_helianthoides	LC
Apium_graveolens	NE
Apium_inundatum	NE
Apodytes_dimidiata	LC
Aponogeton_angustifolius	VU
Aponogeton_distachyos	LC
Araujia_sericifolia	NA
Arctopus_echinatus	LC
Arctotheca_calendula	LC
Arctotheca_forbesiana	CR
Arctotheca_populifolia	LC
Arctotheca_prostrata	LC
Arctotis_acaulis	LC
Arctotis_angustifolia	CR
Arctotis_aspera	LC
Arctotis_hirsuta	LC
Arctotis_leptorhiza	LC
Arctotis_perfoliata	LC
Arctotis_revoluta	LC
Arctotis_stoechadifolia	LC
Argemone_subfusiformis	NE
Argyrolobium_filiforme	LC
Argyrolobium_lanceolatum	LC
Argyrolobium_velutinum	EN
Aristea_africana	LC
Aristea_confusa	LC
Aristea_cuspidata	LC
Aristea_dichotoma	LC
Aristea_glauca	LC
Aristea_juncifolia	LC
Aristea_macrocarpa	LC
Aristea_major	LC
Aristea_pauciflora	DDT
Aristea_rigidifolia	DDT
Aristea_spiralis	LC
Aristea_zeyheri	Rare
Aristida_diffusa	LC
Aristida_junciformis	LC
Aristolochea_littoralis	NA
Arrhenantherum_elatius	NA
Arundo_donax	NE
Asclepias_brevicuspis	LC
Asclepias_cancellata	NE
Asclepias_crispa	LC
Aspalathus_abietina	LC
Aspalathus_acuminata	LC
Aspalathus_albens	VU
Aspalathus_angustifolia	LC
Aspalathus_araneosa	VU
Aspalathus_argyrella	LC
Aspalathus_arida	LC
Aspalathus_aspalathoides	LC
Aspalathus_astroites	LC
Aspalathus_barbata	VU
Aspalathus_borboniifolia	VU
Aspalathus_bracteata	LC
Aspalathus_callosa	LC
Aspalathus_capensis	Rare
Aspalathus_capitata	VU
Aspalathus_carnosa	LC
Aspalathus_cephalotes	LC
Aspalathus_chenopoda	LC
Aspalathus_ciliaris	LC
Aspalathus_commutata	LC
Aspalathus_cordata	LC
Aspalathus_crenata	LC
Aspalathus_cymbiformis	LC
Aspalathus_divaricata	LC
Aspalathus_ericifolia	LC
Aspalathus_filicaulis	LC
Aspalathus_forbesii	LC
Aspalathus_globulosa	VU
Aspalathus_hispida	LC
Aspalathus_humilis	Rare
Aspalathus_hybrid	NA
Aspalathus_incurva	Rare
Aspalathus_juniperina	LC
Aspalathus_laricifolia	LC
Aspalathus_lebeckioides	VU
Aspalathus_linearis	LC
Aspalathus_linguiloba	LC
Aspalathus_lotoides	VU
Aspalathus_macrantha	EN
Aspalathus_microphylla	LC
Aspalathus_neglecta	LC
Aspalathus_psoraleoides	EN
Aspalathus_quinquefolia	LC
Aspalathus_radiata	LC
Aspalathus_retroflexa	LC
Aspalathus_salteri	NT
Aspalathus_sericea	LC
Aspalathus_serpens	LC
Aspalathus_spicata	LC
Aspalathus_spinosa	LC
Aspalathus_ternata	VU
Aspalathus_tridentata	Rare
Aspalathus_uniflora	LC
Aspalathus_variegata	EX
Aspalathus_willdenowiana	LC
Asparagus_aethiopicus	LC
Asparagus_africanus	LC
Asparagus_asparagoides	LC
Asparagus_capensis	LC
Asparagus_compactus	NA
Asparagus_declinatum	NA
Asparagus_exuvialis	NA
Asparagus_kraussianum	NA
Asparagus_ovatum	NA
Asparagus_retrofractus	LC
Asparagus_rubicundus	LC
Asparagus_scandens	LC
Asparagus_stipulaceus	NT
Asparagus_undulatum	NA
Aspidoglossum_gracile	LC
Aspidoglossum_heterophyllum	LC
Asplenium_adiantum-nigrum	LC
Asplenium_aethiopicum	LC
Asplenium_erectum	LC
Asplenium_lunulatum	LC
Asplenium_monanthes	LC
Astephanus_triflorus	LC
Aster_subulata	NA
Athanasia_capitata	EN
Athanasia_crithmifolia	LC
Athanasia_dentata	LC
Athanasia_juncea	LC
Athanasia_pinnata	LC
Athanasia_trifurcata	LC
Athrixia_crinita	LC
Atriplex_cinerea	LC
Atriplex_lindleyi	NE
Atriplex_muelleri	NE
Atriplex_nummularia	NE
Atriplex_patula	LC
Atriplex_semibaccata	LC
Audouinia_capitata	Rare
Aulax_cancellata	LC
Avena_barbata	NE
Avena_fatua	NE
Avena_sativa	NE
Avena_sterilis	NE
Azolla_filiculoides	NE
Babiana_ambigua	LC
Babiana_disticha	NT
Babiana_nana	VU
Babiana_ringens	LC
Babiana_stricta	NT
Babiana_tubulosa	VU
Babiana_villosula	EN
Baeometra_uniflora	LC
Ballota_africana	LC
Barbarea_verna	NE
Bartholina_burmanniana	LC
Bartholina_ethelae	NA
Bartsia_trixago	LC
Bergia_glomerata	LC
Berkheya_armata	LC
Berkheya_barbata	LC
Berkheya_pinnatifida	LC
Berkheya_rigida	LC
Berula_erecta	LC
Berzelia_abrotanoides	LC
Berzelia_intermedia	LC
Berzelia_lanuginosa	LC
Beta_vulgaris	NE
Bidens_pilosa	NE
Blechnum_australe	LC
Blechnum_capense	LC
Blechnum_giganteum	LC
Blechnum_punctulatum	LC
Blechnum_tabulare	LC
Bobartia_filiformis	LC
Bobartia_gladiata	LC
Bobartia_indica	LC
Bolboschoenus_maritimus	LC
Bolusafra_bituminosa	LC
Bonatea_speciosa	LC
Brabejum_stellatifolium	LC
Brachycarpaea_juncea	NA
Brachylaena_discolor	LC
Brachylaena_elliptica	LC
Brachylaena_neriifolia	LC
Brachypodium_distachyon	NE
Brachypodium_flexum	LC
Brachysiphon_fucatus	Rare
Brachystelma_occidentale	CR
Brassica_napus	NA
Brassica_nigra	NE
Brassica_oleracea	NA
Brassica_tournefortii	NE
Briza_maxima	NE
Briza_minor	NE
Bromus_catharticus	NE
Bromus_diandrus	NE
Bromus_hordeaceus	NE
Bromus_leptoclados	LC
Bromus_pectinatus	LC
Brunia_nodiflora	LC
Brunsvigia_orientalis	LC
Bryomorphe_lycopodioides	LC
Buchnera_glabrata	LC
Buddleja_madagascariensis	NA
Buglossoides_arvensis	NE
Bulbine_abyssinica	LC
Bulbine_alooides	LC
Bulbine_annua	LC
Bulbine_cepacea	LC
Bulbine_favosa	LC
Bulbine_frutescens	LC
Bulbine_lagopus	LC
Bulbine_praemorsa	LC
Bulbinella_nutans	LC
Bulbinella_triquetra	LC
Bulbostylis_humilis	LC
Bupleurum_mundtii	NA
Bupleurum_rotundifolium	NE
Caesia_contorta	LC
Calopsis_fruiticosa	NA
Calopsis_gracilis	LC
Calopsis_membranacea	LC
Calopsis_paniculata	LC
Calopsis_rigorata	LC
Calopsis_viminea	LC
Calystegia_sepium	NE
Campylostachys_cernua	LC
Canna_indica	NE
Cannabis_sativa	NE
Cannomois_virgata	LC
Canthium_inerme	LC
Canthium_mundtianum	NA
Capnophyllum_africanum	NT
Capsella_bursa-pastoris	NE
Cardamine_africana	LC
Cardamine_hirsuta	NE
Carduus_pycnocephalus	NE
Carex_acutiformis	NE
Carex_aethiopica	LC
Carex_clavata	LC
Carex_cognata	LC
Carex_ecklonii	LC
Carex_glomerabilis	LC
Carpacoce_spermacocea	LC
Carpacoce_vaginellata	LC
Carpanthea_pomeridiana	LC
Carpha_bracteosa	LC
Carpha_capitellata	LC
Carpha_glomerata	LC
Carpobrotus_acinaciformis	LC
Carpobrotus_edulis	LC
Carpobrotus_murii	NA
Carpolyza_spiralis	LC
Carthamus_lanatus	NE
Cassine_barbara	LC
Cassine_maritima	LC
Cassine_peragua	LC
Cassine_reticulatum	NA
Cassytha_ciliolata	LC
Castalis_nudicaulis	LC
Castanea_dentata	NA
Castanea_sativa	NA
Casuarina_cunnighamiana	NA
Casuarina_equisitifolia	NA
Catapodium_rigidum	NE
Cedronella_canariensis	NE
Celtis_africana	LC
Celtis_sinensis	NA
Cenia_turbinata	LC
Centaurea_calcitrapa	NE
Centaurea_melitensis	NE
Centella_affinis	LC
Centella_asiatica	LC
Centella_caespitosa	VU
Centella_capensis	LC
Centella_difformis	LC
Centella_eriantha	LC
Centella_flexuosa	LC
Centella_glabrata	LC
Centella_macrocarpa	LC
Centella_macrodus	LC
Centella_montana	LC
Centella_scabra	LC
Centella_tridentata	EN
Centella_triloba	LC
Centella_villosa	LC
Centella_virgata	LC
Centranthus_ruber	NE
Cephalaria_rigida	LC
Cerastium_capense	LC
Cerastium_glomeratum	LC
Ceratandra_atrata	LC
Ceratandra_bicolor	LC
Ceratandra_globosa	LC
Ceratandra_harveyana	LC
Ceratotheca_triloba	LC
Cereus_jamacaru	NE
Ceropegia_africana	LC
Cestrum_laevigatum	NE
Ceterach_cordatum	LC
Chaetobromus_shraderi	NA
Chamaesyce_inequilatera	NA
Chamaesyce_maculata	NE
Chamaesyse_serpens	NA
Chamarea_capensis	LC
Chamira_circaeoides	LC
Chasmanthe_aethiopica	LC
Chasmanthe_floribunda	LC
Cheilanthes_capensis	LC
Cheilanthes_contracta	LC
Cheilanthes_hastata	LC
Cheilanthes_multifida	LC
Cheilanthes_namaquensis	LC
Cheilanthes_viridis	LC
Chenolea_diffusa	LC
Chenopodium_album	NE
Chenopodium_ambrosioides	NE
Chenopodium_botryodes	NE
Chenopodium_carinatum	NE
Chenopodium_giganteum	NE
Chenopodium_glaucum	NE
Chenopodium_mucronatum	LC
Chenopodium_multifidum	NE
Chenopodium_murale	NE
Chenopodium_phillipsianum	NE
Chenopodium_polyspermum	NE
Chinchonia_pubescens	NA
Chionanthus_foveolata	NA
Chironia_baccifera	LC
Chironia_decumbens	LC
Chironia_jasminoides	LC
Chironia_linoides	LC
Chironia_melampyrifolia	LC
Chironia_tetragonia	NA
Chloris_gayana	LC
Chlorophytum_capense	LC
Chlorophytum_comosum	LC
Chlorophytum_rangei	LC
Chlorophytum_triflorum	LC
Chondropetalum_deustum	LC
Chondropetalum_ebracteatum	NE
Chondropetalum_hookerianum	NA
Chondropetalum_microcarpum	NE
Chondropetalum_mucronatum	LC
Chondropetalum_nudum	LC
Chondropetalum_rectum	NT
Chondropetalum_tectorum	NE
Chrysanthemoides_incana	LC
Chrysanthemoides_monilifera	LC
Chrysanthemum_carinatum	NA
Chrysanthemum_segetum	NE
Chrysithrix_capensis	NA
Chrysithrix_dodii	NA
Chrysochoma_coma_-_aurea	NA
Cineraria_geifolia	LC
Cineraria_mitellifolia	LC
Cinnamomum_camphora	NE
Cirsium_vulgare	NE
Cissampelos_capensis	LC
Cistus_ladanifer	NA
Citrullus_lanatus	LC
Cladium_mariscus	LC
Cladoraphis_cyperoides	LC
Clematis_brachiata	LC
Clematis_recta	NA
Cleretum_herrei	LC
Cleretum_papulosum	LC
Cliffortia_atrata	LC
Cliffortia_carinata	Rare
Cliffortia_cymbifolia	DDT
Cliffortia_dentata	LC
Cliffortia_discolor	DDT
Cliffortia_dodecandra	LC
Cliffortia_dregeana	EN
Cliffortia_ericifolia	EN
Cliffortia_eriocephalina	LC
Cliffortia_falcata	LC
Cliffortia_ferruginea	LC
Cliffortia_filicaulis	LC
Cliffortia_filifolia	LC
Cliffortia_glauca	LC
Cliffortia_graminea	LC
Cliffortia_hirta	EN
Cliffortia_hybrids	NA
Cliffortia_ilicifolia	Rare
Cliffortia_integerrima	VU
Cliffortia_intermedia	DDT
Cliffortia_juniperina	LC
Cliffortia_marginata	EN
Cliffortia_multiformis	NT
Cliffortia_obcordata	LC
Cliffortia_odorata	LC
Cliffortia_pedunculata	LC
Cliffortia_polygonifolia	LC
Cliffortia_pterocarpa	LC
Cliffortia_ramosissimum	NA
Cliffortia_ruscifolia	Rare
Cliffortia_stricta	LC
Cliffortia_strobilifera	LC
Cliffortia_subsetacea	LC
Cliffortia_theodori_-_friesii	NA
Clutia_alaternoides	LC
Clutia_daphnoides	LC
Clutia_ericoides	LC
Clutia_polygonoides	LC
Clutia_pterogona	LC
Clutia_pubescens	LC
Clutia_pulchella	LC
Coccosperma_hexandrum	LC
Coelanthum_semiquinquefidum	LC
Coleonema_album	LC
Commelina_africana	LC
Commelina_benghalensis	LC
Conicosia_pugioniformis	LC
Convolvulus_arvensis	NE
Convolvulus_farinosus	LC
Convolvulus_sagittatus	LC
Conyza_bonariensis	NE
Conyza_canadensis	NE
Conyza_hybrid	NA
Conyza_pinnata	LC
Conyza_pinnatifida	LC
Conyza_scabrida	LC
Coriandrum_sativum	NE
Coronopus_didymus	NE
Coronopus_squamatus	NE
Corrigiola_capensis	LC
Corrigiola_litoralis	LC
Cortaderia_jubata	NE
Cortaderia_selloana	NE
Corycium_bicolorum	LC
Corycium_bifidum	CR
Corycium_carnosum	LC
Corycium_crispum	LC
Corycium_excisum	LC
Corycium_microglossum	CR
Corycium_orobanchoides	LC
Corymbium_africanum	LC
Corymbium_enerve	LC
Corymbium_glabrum	LC
Cotoneaster_franchetii	NE
Cotoneaster_lacteus	NA
Cotoneaster_pannosus	NE
Cotula_anthemoides	LC
Cotula_coronopifolia	LC
Cotula_eckloniana	EN
Cotula_filifolia	CR
Cotula_hybrid	NA
Cotula_myriophylloides	CR
Cotula_vulgaris	LC
Cotyledon_orbiculata	LC
Crassula_atropurpurea	LC
Crassula_campestris	LC
Crassula_capensis	LC
Crassula_ciliata	LC
Crassula_coccinea	LC
Crassula_cymosa	LC
Crassula_decumbens	LC
Crassula_dejecta	LC
Crassula_dichotoma	LC
Crassula_expansa	LC
Crassula_fallax	LC
Crassula_fascicularis	LC
Crassula_filiformis	LC
Crassula_flava	LC
Crassula_glomerata	LC
Crassula_hybrid_C.pruinosa_x_scabra	NA
Crassula_muscosa	LC
Crassula_natans	LC
Crassula_nudicaulis	LC
Crassula_oblanceolata	LC
Crassula_obtusa	LC
Crassula_papillosa	LC
Crassula_pellucida	LC
Crassula_pruinosa	LC
Crassula_rupestris	LC
Crassula_saxifraga	LC
Crassula_scabra	LC
Crassula_strigosa	LC
Crassula_subulata	LC
Crassula_tetragona	LC
Crassula_thunbergiana	LC
Crassula_tomentosa	LC
Crassula_umbellata	LC
Crassula_vaillantii	NE
Crepidomanes_melanotrichum	LC
Crossyne_guttata	LC
Crotalaria_capensis	LC
Crotalaria_exisa	NA
Cryptadenia_grandiflora	VU
Cryptadenia_uniflora	VU
Cryptomeria_japonica	NE
Cucumis_africanus	LC
Cucumis_myriocarpus	LC
Cullumia_ciliaris	LC
Cullumia_setosa	LC
Cullumia_squarrosa	EN
Cunonia_capensis	LC
Curtisia_dentata	NT
Cuscuta_angulata	LC
Cuscuta_appendiculata	LC
Cuscuta_campestris	NE
Cuscuta_nitida	LC
Cussonia_thyrsiflora	LC
Cyanella_hyacinthoides	LC
Cyathea_capensis	Declining
Cyathea_dregei	LC
Cyathocoma_hexandra	LC
Cyclopia_buxifloia	NA
Cyclopia_capensis	LC
Cyclopia_galioides	LC
Cyclopia_genistoides	LC
Cymbalaria_muralis	NE
Cymbopogon_marginatus	LC
Cynanchum_africanum	LC
Cynanchum_obtusifolium	LC
Cynanchum_zeyheri	LC
Cynodon_dactylon	LC
Cynoglossum_hispidum	LC
Cynosurus_echinatus	NE
Cyperus_denudatus	LC
Cyperus_entrerianus	NA
Cyperus_esculentus	LC
Cyperus_fastigiatus	LC
Cyperus_laevigatus	LC
Cyperus_longus	LC
Cyperus_rotundus	LC
Cyperus_rupestris	LC
Cyperus_sphaerospermus	LC
Cyperus_tenellus	LC
Cyperus_textilis	LC
Cyphia_bulbosa	DDT
Cyphia_campestris	DDT
Cyphia_crenata	LC
Cyphia_dentariifolia	DDT
Cyphia_digitata	LC
Cyphia_incisa	LC
Cyphia_phyteuma	LC
Cyphia_volubilis	LC
Cyphia_zeyheriana	LC
Cyrtanthus_ventricosus	LC
Cysticapnos_cracca	LC
Cysticapnos_vesicarius	NA
Cytinus_capensis	CR_PE
Cytinus_sanguineus	LC
Cytisus_monspessulanus	NA
Dactylis_glomerata	NE
Dasispermum_suffruticosa	NA
Datura_stramonium	NE
Daucus_carota	NE
Delosperma_asperulum	NA
Dianella_tasmanica	NA
Dianthus_albens	LC
Diascia_capensis	LC
Diascia_diffusa	LC
Diascia_elongata	LC
Diascia_sacculata	LC
Diastella_divaricata	Rare
Diastella_proteoides	CR
Dichondra_repens	NE
Didymodoxa_capensis	LC
Digitaria_abyssinica	NA
Digitaria_debilis	LC
Digitaria_diversinervis	LC
Digitaria_eriantha	LC
Digitaria_sanguinalis	NE
Dilatris_corymbosa	LC
Dilatris_pillansii	LC
Dilatris_viscosa	LC
Dimorphotheca_pluvialis	LC
Diosma_demissa	VU
Diosma_hirsuta	LC
Diosma_oppositifolia	LC
Diospyros_glabra	LC
Diospyros_whyteana	LC
Dipcadi_brevifolium	LC
Diplachne_fusca	LC
Diplachne_livida	NA
Diplotaxis_muralis	NE
Dipogon_lignosus	LC
Disa_(Herschelianthe)_forficaria	NA
Disa_atricapilla	LC
Disa_bivalvata	LC
Disa_bodkinii	Rare
Disa_cornuta	LC
Disa_cylindrica	LC
Disa_draconis	EN
Disa_fasciata	LC
Disa_ferruginea	LC
Disa_filicornis	LC
Disa_glandulosa	LC
Disa_lineata	Rare
Disa_longicornu	VU
Disa_maculata	LC
Disa_micropetala	LC
Disa_nubigena	CR
Disa_obtusa	LC
Disa_ocellata	Rare
Disa_oligantha	Rare
Disa_patens	LC
Disa_racemosa	LC
Disa_richardiana	LC
Disa_rosea	LC
Disa_salteri	LC
Disa_telipogonis	LC
Disa_tenella	Rare
Disa_tenuicornis	LC
Disa_tenuifolia	LC
Disa_tenuis	Rare
Disa_uncinata	LC
Disa_uniflora	LC
Disa_vaginata	LC
Disa_venosa	LC
Dischisma_arenarium	LC
Dischisma_capitatum	LC
Dischisma_ciliatum	LC
Discocapnos_mundtii	NA
Disparago_anomala	LC
Disparago_lasiocarpa	LC
Disparago_laxifolia	LC
Disperis_bodkinii	LC
Disperis_bolusiana	LC
Disperis_capensis	LC
Disperis_circumflexa	LC
Disperis_cucullata	NT
Disperis_paludosa	LC
Disperis_villosa	LC
Disphyma_crassifolium	LC
Dittrichia_graveolens	NE
Dodonaea_angustifolia	LC
Dolichos_decumbens	LC
Dorotheanthus_apetalus	VU
Dorotheanthus_bellidiformis	LC
Dorotheanthus_gramineus	VU
Drimia_capensis	LC
Drimia_duthieae	NA
Drimia_elata	DDT
Drimia_exuviata	LC
Drimia_marginata	LC
Drimia_media	LC
Drimia_minor	DDT
Drimia_modesta	LC
Droguetia_ambigua	LC
Droguetia_sp.	NA
Drosanthemum_candens	LC
Drosanthemum_floribundum	LC
Drosanthemum_stokoei	LC
Drosera_aliciae	LC
Drosera_capensis	LC
Drosera_cistiflora	LC
Drosera_cuneifolia	LC
Drosera_glabripes	LC
Drosera_hilaris	LC
Drosera_ramentacea	LC
Drosera_trinervia	LC
Dryopteris_inequalis	NA
Echinochloa_crus-galli	LC
Echinochloa_pyrimidalis	NA
Echium_candicans	NA
Echium_plantagineum	NE
Edmondia_pinifolia	LC
Edmondia_sesamoides	LC
Ehrharta_brevifolia	LC
Ehrharta_bulbosa	LC
Ehrharta_calycina	LC
Ehrharta_capensis	LC
Ehrharta_erecta	LC
Ehrharta_longiflora	LC
Ehrharta_melicoides	LC
Ehrharta_ottonis	LC
Ehrharta_ramosa	LC
Ehrharta_rehmannii	LC
Ehrharta_rupestris	LC
Ehrharta_setacea	LC
Ehrharta_setaceae	NA
Ehrharta_villosa	LC
Eichornia_crassipes	NA
Elaphoglossum_acrostichoides	LC
Elaphoglossum_conforme	LC
Elegia_asperiflora	LC
Elegia_capensis	LC
Elegia_coleura	LC
Elegia_cuspidata	LC
Elegia_fenestrata	VU
Elegia_filacea	LC
Elegia_fistulosa	LC
Elegia_intermedia	DDT
Elegia_juncea	LC
Elegia_neesii	LC
Elegia_prominens	VU
Elegia_racemosa	LC
Elegia_squamosa	LC
Elegia_stipularis	LC
Elegia_thyrsifera	LC
Elegia_vaginulata	LC
Elegia_verrauxii	NA
Eleocharis_lepta	NA
Eleocharis_limosa	LC
Eleocharis_schlechteri	DDT
Eleusine_corocana	NA
Eleusine_indica	LC
Elytropappus_glandulosus	NA
Elytropappus_gnaphaloides	NA
Elytropappus_longifolius	NA
Elytropappus_rhinocerotis	LC
Elytropappus_scaber	NA
Emex_australis	NE
Empodium_plicatum	LC
Epilobium_hirsutum	LC
Epilobium_tetragonium	NA
Epischoenus_adnatus	LC
Epischoenus_gracilis	LC
Epischoenus_quadrangularis	LC
Epischoenus_villosus	LC
Eragrostis_capensis	LC
Eragrostis_curvula	LC
Eragrostis_cyperoides	LC
Eragrostis_echinochloidea	LC
Eragrostis_eliator	NA
Eragrostis_lehmanniana	LC
Eragrostis_sabulosa	LC
Eragrostis_sarmentosa	LC
Eragrostis_subulata	NA
Erepsia_anceps	LC
Erepsia_aspera	LC
Erepsia_bracteata	LC
Erepsia_forficata	Rare
Erepsia_gracilis	LC
Erepsia_patula	VU
Erepsia_promontorii	CR_PE
Erica_abietina	LC
Erica_amoena	Rare
Erica_annectens	VU
Erica_articularis	LC
Erica_baccans	LC
Erica_benthamiana	LC
Erica_blancheana	LC
Erica_blenna	LC
Erica_brachialis	EN
Erica_brevifolia	LC
Erica_bruniades	LC
Erica_caffra	LC
Erica_calycina	LC
Erica_canescens	LC
Erica_capensis	Rare
Erica_capillaris	CR
Erica_capitata	VU
Erica_caterviflora	EN
Erica_cerinthoides	LC
Erica_clavisepala	Rare
Erica_coarctata	LC
Erica_coccinea	LC
Erica_conica	LC
Erica_coriifolia	NA
Erica_crenata	EN
Erica_cristiflora	LC
Erica_curviflora	LC
Erica_curvirostris	LC
Erica_cyrilliflora	EN
Erica_depressa	LC
Erica_diosmifolia	Rare
Erica_distorta	LC
Erica_dodii	LC
Erica_eburnea	Rare
Erica_empetrina	LC
Erica_equisetifolia	LC
Erica_ericoides	LC
Erica_exleeana	LC
Erica_fairii	VU
Erica_fastigiata	DDT
Erica_ferrea	EN
Erica_fontana	Rare
Erica_genistifolia	LC
Erica_gilva	LC
Erica_glabella	LC
Erica_glandulosa	LC
Erica_glutinosa	LC
Erica_gnaphaloides	LC
Erica_haematocodon	Rare
Erica_halicacaba	LC
Erica_heleogena	CR
Erica_hirtiflora	LC
Erica_hispidula	LC
Erica_hybrid	NA
Erica_imbricata	LC
Erica_inops	LC
Erica_labialis	LC
Erica_laeta	LC
Erica_lasciva	LC
Erica_limosa	VU
Erica_lucida	LC
Erica_lutea	LC
Erica_mammosa	LC
Erica_margaritacea	CR
Erica_marifolia	VU
Erica_mauritanica	LC
Erica_mollis	LC
Erica_monadelpha	NA
Erica_multumbellifera	LC
Erica_muscosa	LC
Erica_nevillei	Rare
Erica_nivea	LC
Erica_nudiflora	LC
Erica_obliqua	LC
Erica_obtusata	LC
Erica_oxycoccifolia	LC
Erica_palliiflora	LC
Erica_paludicola	VU
Erica_paniculata	LC
Erica_parviflora	DDT
Erica_parvula	LC
Erica_patersonia	NA
Erica_petiolaris	LC
Erica_peziza	LC
Erica_phylicifolia	LC
Erica_physodes	LC
Erica_pilulifera	VU
Erica_placentiflora	LC
Erica_planifolia	DDT
Erica_plukenetii	LC
Erica_pubescens	DDT
Erica_pulchella	DDT
Erica_pyramidalis	EX
Erica_pyxidiflora	LC
Erica_quadrisulcata	Rare
Erica_salteri	DDT
Erica_sessiliflora	LC
Erica_sexfaria	LC
Erica_sociorum	CR
Erica_speciosa	LC
Erica_spumosa	LC
Erica_strigosa	LC
Erica_subcapitata	LC
Erica_subdivaricata	LC
Erica_tenuifolia	LC
Erica_tenuis	LC
Erica_thimifolia	LC
Erica_transparens	LC
Erica_triflora	LC
Erica_tristis	LC
Erica_turgida	EW
Erica_urceolata	LC
Erica_urna-viridis	Rare
Erica_urticulosa	NA
Erica_velitaris	LC
Erica_versicolor	LC
Erica_verticillata	EW
Erica_viscaria	CR_PE
Eriobotrya_japonica	NA
Eriocephalus_africanus	LC
Eriocephalus_racemosus	LC
Eriospermum_capense	LC
Eriospermum_cernuum	LC
Eriospermum_cordiforme	LC
Eriospermum_lancifolium	NA
Eriospermum_nanum	LC
Eriospermum_pumilum	LC
Eriospermum_spirale	VU
Eriospermum_stoloniferum	VU
Erodium_botrys	NE
Erodium_cicutarium	NE
Erodium_malacoides	NE
Erodium_moschatum	NE
Erucastrum_gallicum	NA
Eucalyptus_camaldulensis	NE
Eucalyptus_conferruminata	NA
Eucalyptus_diversicolor	NA
Eucalyptus_gomphocephala	NE
Eucalyptus_grandis	NE
Euclea_acutifolia	LC
Euclea_racemosa	LC
Euclea_tomentosa	LC
Eulophia_aculeata	LC
Eulophia_chlorantha	DDD
Eulophia_tabularis	LC
Euphorbia_arceuthobioides	LC
Euphorbia_caput-medusae	LC
Euphorbia_chamaesyce	NE
Euphorbia_erythrina	LC
Euphorbia_foliosa	LC
Euphorbia_genistoides	LC
Euphorbia_helioscopia	NE
Euphorbia_marlothiana	DDT
Euphorbia_mauritanica	LC
Euphorbia_peplus	NE
Euphorbia_pubescens	LC
Euphorbia_silenifolia	LC
Euphorbia_terracina	NA
Euphorbia_tuberosa	LC
Euryops_abrotanifolius	LC
Euryops_pectinatus	VU
Eustegia_filiformis	LC
Eustegia_fraterna	Thr*
Eustegia_minuta	LC
Evotella_rubiginosa	Rare
Exomis_microphylla	LC
Fagopyrum_esculantum	NA
Falckia_repens	NA
Fallopia_convolvulus	NE
Felicia_aethiopica	LC
Felicia_amoena	LC
Felicia_bergerana	NA
Felicia_cymbalariae	LC
Felicia_cymbalariodes	NA
Felicia_fruticosa	LC
Felicia_heterophylla	LC
Felicia_hyssopifolia	LC
Felicia_tenella	LC
Ferraria_crispa	LC
Festuca_scabra	LC
Ficinia_acuminata	LC
Ficinia_anceps	Rare
Ficinia_angustifolia	LC
Ficinia_argyropa	LC
Ficinia_bergiana	LC
Ficinia_brevifolia	LC
Ficinia_bulbosa	LC
Ficinia_capillifolia	LC
Ficinia_capitella	LC
Ficinia_deusta	LC
Ficinia_dunensis	LC
Ficinia_ecklonia	NA
Ficinia_elatior	VU
Ficinia_fastigiata	VU
Ficinia_filiformis	LC
Ficinia_indica	LC
Ficinia_ixioides	LC
Ficinia_lateralis	LC
Ficinia_micrantha	EN
Ficinia_nigrescens	LC
Ficinia_oligantha	LC
Ficinia_pallens	LC
Ficinia_paradoxa	LC
Ficinia_pinquior	NA
Ficinia_polystachya	LC
Ficinia_pygmaea	NT
Ficinia_radiata	LC
Ficinia_ramosissima	LC
Ficinia_rigida	VU
Ficinia_secunda	LC
Ficinia_stolonifera	LC
Ficinia_tenuifolia	LC
Ficinia_trichodes	LC
Ficinia_tristachya	LC
Ficinia_x_lucida	NA
Ficinia_zeyheri	LC
Ficus_carica	NA
Foeniculum_vulgare	NE
Frankenia_pulverulenta	LC
Frankenia_repens	LC
Fraxinus_americana	NA
Fuirena_coerulescens	LC
Fuirena_hirsuta	LC
Fumaria_muralis	NA
Galaxia_alata	CR
Galaxia_albiflora	LC
Galaxia_fugacissima	LC
Galaxia_ovata	LC
Galaxia_versicolor	VU
Galenia_africana	LC
Galenia_crystallina	LC
Galenia_filiformis	LC
Galenia_herniariaefolia	LC
Galenia_pubescens	LC
Galenia_secunda	LC
Galinsoga_parviflora	NE
Galium_spurium-aparine	LC
Galium_tomentosum	LC
Gamochaeta_purpurea	NA
Gastridium_phleoides	NE
Gastrodia_sesamoides	NE
Gazania_maritima	LC
Gazania_pectinata	LC
Geissorhiza_aspera	LC
Geissorhiza_bolusii	LC
Geissorhiza_bonae-spei	NA
Geissorhiza_brehmii	VU
Geissorhiza_hispidula	LC
Geissorhiza_humilis	VU
Geissorhiza_imbricata	NT
Geissorhiza_inflexa	LC
Geissorhiza_juncea	LC
Geissorhiza_ovata	LC
Geissorhiza_pusilla	LC
Geissorhiza_setacea	EN
Geissorhiza_similis	LC
Geissorhiza_tabularis	Rare
Geissorhiza_tenella	VU
Geissorhiza_umbrosa	LC
Geranium_canescens	LC
Geranium_dissectum	NE
Geranium_incanum	LC
Geranium_molle	NE
Geranium_ornithopodon	LC
Geranium_purpureum	NE
Geranium_rotundifolium	NE
Gerbera_crocea	LC
Gerbera_hybrid	NA
Gerbera_integralis	LC
Gerbera_linnaei	LC
Gerbera_piloselloides	LC
Gerbera_wrightii	Rare
Gethyllis_afra	LC
Gethyllis_ciliaris	NT
Gethyllis_kaapensis	EN
Gethyllis_villosa	LC
Gibbaria_ilicifolia	LC
Gladiolus_alatus	LC
Gladiolus_angustus	LC
Gladiolus_aureus	CR
Gladiolus_bonaespei	NA
Gladiolus_brevifolius	LC
Gladiolus_carinatus	LC
Gladiolus_carneus	LC
Gladiolus_cunonius	LC
Gladiolus_debilis	LC
Gladiolus_gracilis	LC
Gladiolus_hyalinus	LC
Gladiolus_jonquilliodorus	EN
Gladiolus_liliaceus	LC
Gladiolus_maculatus	LC
Gladiolus_monticola	Rare
Gladiolus_ornatus	LC
Gladiolus_pillansii	LC
Gladiolus_priorii	LC
Gladiolus_punctulatus	LC
Gladiolus_quadrangulus	EN
Gladiolus_tristis	LC
Gladiolus_undulatus	LC
Gladiolus_vigilans	EN
Gladiolus_watsonius	NT
Gleichenia_polypodioides	LC
Glia_capensis	LC
Gnaphalium_declinatum	NT
Gnaphalium_pauciflorum	LC
Gnaphalium_subfalcatum	NE
Gnidia_anomala	LC
Gnidia_humilis	EN
Gnidia_hybrids	NA
Gnidia_imbricata	LC
Gnidia_inconspicua	LC
Gnidia_juniperifolia	LC
Gnidia_laxa	LC
Gnidia_linoides	LC
Gnidia_nana	LC
Gnidia_oppositifolia	LC
Gnidia_parviflora	DDT
Gnidia_parvula	DDD
Gnidia_penicillata	NT
Gnidia_pinifolia	LC
Gnidia_sericea	LC
Gnidia_spicata	VU
Gnidia_squarrosa	LC
Gnidia_subulata	NA
Gnidia_tomentosa	LC
Gomphocarpus_fruticosus	LC
Gomphocarpus_physocarpus	LC
Gomphrena_celosioides	NE
Gorteria_personata	LC
Grammatotheca_bergiana	LC
Grewia_occidentalis	LC
Grielum_grandiflorum	LC
Grubbia_rosmarinifolia	LC
Grubbia_tomentosa	LC
Gunnera_perpensa	Declining
Gymnodiscus_capillaris	LC
Gymnosporia_buxifolia	LC
Gynandriris_setifolia	LC
Haemanthus_coccineus	LC
Haemanthus_pubescens	Rare
Haemanthus_sanguineus	LC
Hainardia_cylindrica	NE
Hakea_drupacea	NE
Hakea_gibbosa	NE
Hakea_salicifolia	NE
Hakea_sericea	NE
Halleria_lucida	LC
Halopeplis_nodulosa	NA
Haplocarpha_lanata	LC
Hartogiella_schinoides	LC
Harveya_bolusii	LC
Harveya_capensis	LC
Harveya_coccinea	LC
Harveya_laxiflora	LC
Harveya_purpurea	NA
Harveya_squamosa	LC
Harveya_tubulosa	LC
Hebenstreitia_cordata	NA
Hebenstreitia_dentata	NA
Hebenstreitia_fastigiosa	NA
Hebenstreitia_integrifolia	NA
Hebenstreitia_ramossissima	NA
Hebenstreitia_repens	NA
Hedera_helix	NA
Hedychium_coccineum	NA
Hedychium_coronarium	NE
Hedypnois_cretica	NE
Helichrysum_anomalum	LC
Helichrysum_asperum	LC
Helichrysum_capense	LC
Helichrysum_crispum	LC
Helichrysum_cylindriflorum	LC
Helichrysum_cymosum	LC
Helichrysum_dasyanthum	LC
Helichrysum_felinum	LC
Helichrysum_foetidum	LC
Helichrysum_fruticans	Rare
Helichrysum_grandiflorum	LC
Helichrysum_helianthemifolium	LC
Helichrysum_indicum	LC
Helichrysum_litorale	LC
Helichrysum_marifolium	Rare
Helichrysum_moeserianum	LC
Helichrysum_niveum	LC
Helichrysum_nudifolium	LC
Helichrysum_odoratissimum	LC
Helichrysum_pandurifolium	LC
Helichrysum_patulum	LC
Helichrysum_retortum	LC
Helichrysum_revolutum	LC
Helichrysum_rotundifolium	LC
Helichrysum_rutilans	LC
Helichrysum_spiralepis	LC
Helichrysum_stellatum	LC
Helichrysum_teretifolium	LC
Helichrysum_tinctum	LC
Helictotrichon_capense	LC
Helictotrichon_dodii	LC
Helictotrichon_hirtulum	LC
Helictotrichon_leoninum	LC
Helictotrichon_longum	LC
Helictotrichon_quinquesetum	CR_PE
Heliophila_acuminata	LC
Heliophila_adpressa	LC
Heliophila_africana	LC
Heliophila_callosa	LC
Heliophila_cinerea	Rare
Heliophila_concatenata	LC
Heliophila_coronopifolia	LC
Heliophila_crithmifolia	LC
Heliophila_diffusa	LC
Heliophila_digitata	LC
Heliophila_lactea	LC
Heliophila_linearis	LC
Heliophila_meyeri	LC
Heliophila_pendula	LC
Heliophila_pinnata	LC
Heliophila_promentorii	NA
Heliophila_pusilla	Thr*
Heliophila_refracta	LC
Heliophila_scoparia	LC
Heliophila_subulata	LC
Heliophila_tabularis	VU
Heliotropium_supinum	NE
Hellmuthia_membranacea	LC
Helxine_solierolii	NA
Hemarthria_altissima	LC
Hemimeris_montana	LC
Hemimeris_sabulosa	LC
Hermannia_alnifolia	LC
Hermannia_althaeifolia	LC
Hermannia_decumbens	LC
Hermannia_diffusa	LC
Hermannia_grossularifolia	LC
Hermannia_hyssopifolia	LC
Hermannia_incana	LC
Hermannia_lavendulifolia	NA
Hermannia_linifolia	LC
Hermannia_micrantha	Rare
Hermannia_modesta	LC
Hermannia_multiflora	LC
Hermannia_pinnata	LC
Hermannia_prismatocarpa	LC
Hermannia_procumbens	EN
Hermannia_rudis	LC
Hermannia_rugosa	VU
Hermannia_salviifolia	LC
Hermannia_scabricaulis	LC
Hermannia_ternifolia	LC
Hermas_capitata	LC
Hermas_pillansii	Rare
Hermas_villosa	LC
Herniaria_capensis	LC
Herschelianthe_barbata	CR
Herschelianthe_graminifolia	LC
Herschelianthe_lugens	EN
Herschelianthe_purpurascens	NT
Herschelianthe_venusta	EN
Herscheliodisa_vogelpoelii	NA
Hesperantha_falcata	LC
Hesperantha_pilosa	LC
Hesperantha_radiata	LC
Hesperantha_spicata	CR
Hessea_cinnamomea	EN
Heteropogon_contortus	LC
Hexaglottis_lewisiae	LC
Hexaglottis_longifolia	LC
Hexaglottis_virgata	Rare
Hibiscus_aethiopicus	LC
Hibiscus_diversifolius	LC
Hibiscus_trionum	NE
Hippia_pilosa	LC
Histiopteris_incisa	LC
Holcus_lanatus	NE
Holcus_setiger	LC
Holothrix_brevipetala	LC
Holothrix_cernua	LC
Holothrix_exilis	LC
Holothrix_mundii	LC
Holothrix_villosa	LC
Homalanthus_populifolius	NE
Homeria_bulbillifera	LC
Homeria_collina	LC
Homeria_flaccida	LC
Homeria_galpinii	LC
Homeria_miniata	LC
Homeria_minor	LC
Homeria_ochroleuca	LC
Hordeum_capense	LC
Hordeum_murinum	NE
Hordeum_vulgare	NA
Huperzia_gnidioides	LC
Hydnora_africana	LC
Hydrocotyle_verticillata	LC
Hymenogyne_glabra	LC
Hymenolepis_parviflora	LC
Hymenophyllum_capense	LC
Hymenophyllum_peltatum	LC
Hymenophyllum_tunbridgense	LC
Hyobanche_atropurpurea	LC
Hyobanche_sanguinea	LC
Hyparrhenia_hirta	LC
Hypericum_canariense	NA
Hypericum_lalandii	LC
Hypericum_perforatum	NE
Hypertelis_arenicola	LC
Hypertelis_trachysperma	CR_PE
Hypochoeris_glabra	NA
Hypochoeris_radicata	NA
Hypodiscus_albo_-_aristatus	NA
Hypodiscus_argenteus	LC
Hypodiscus_aristatus	LC
Hypodiscus_rugosus	LC
Hypodiscus_willdenowia	LC
Hypolepis_sparsisora	LC
Hypolepis_villoso-viscida	NA
Ilex_mitis	Declining
Ilysanthes_dubia	NA
Impatiens_sodeniI	NE
Imperata_cylindrica	LC
Indigofera_aff_gracilis	NA
Indigofera_angustifolia	LC
Indigofera_brachystachya	LC
Indigofera_candolleana	LC
Indigofera_capillaris	LC
Indigofera_complanata	VU
Indigofera_cytisoides	LC
Indigofera_filicaulis	LC
Indigofera_filifolia	LC
Indigofera_filiformis	LC
Indigofera_glomerata	LC
Indigofera_gracilis	LC
Indigofera_incana	LC
Indigofera_mauritanica	LC
Indigofera_obscura	LC
Indigofera_procumbens	LC
Indigofera_psoraloides	VU
Indigofera_racemosa	NE
Indigofera_sarmentosa	LC
Indigofera_torulosa	LC
Ipomoea_indica	NE
Ischyrolepis_capensis	LC
Ischyrolepis_cincinnata	LC
Ischyrolepis_curviramis	LC
Ischyrolepis_eleocharis	LC
Ischyrolepis_gaudichaudiana	LC
Ischyrolepis_ocreata	LC
Ischyrolepis_paludosa	VU
Ischyrolepis_papillosa	VU
Ischyrolepis_pratensis	EN
Ischyrolepis_sieberi	LC
Ischyrolepis_sporadica	LC
Ischyrolepis_tenuissima	LC
Ischyrolepis_triflora	LC
Isoetes_capensis	EN
Isoetes_stellenbossiensis	NT
Isolepis_antarctica	LC
Isolepis_brevicaulis	LC
Isolepis_bulbifera	EX
Isolepis_cernua	LC
Isolepis_digitata	LC
Isolepis_hystrix	LC
Isolepis_incomtula	LC
Isolepis_inconspicua	EN
Isolepis_leucoloma	VU
Isolepis_ludwigii	LC
Isolepis_marginata	LC
Isolepis_natans	LC
Isolepis_prolifer	NA
Isolepis_pusilla	DDD
Isolepis_rubicunda	LC
Isolepis_sororia	LC
Isolepis_striata	LC
Isolepis_venustulus	NA
Isolepis_verrucosula	LC
Itasina_filifolia	LC
Ixia_dubia	Declining
Ixia_maculata	EN
Ixia_monadelpha	EN
Ixia_odorata	LC
Ixia_paniculata	LC
Ixia_polystachya	LC
Ixia_scillaris	LC
Jacaranda_mimosifolia	NE
Jordaaniella_dubia	LC
Juncus_bufonius	NE
Juncus_capensis	LC
Juncus_capillaceus	NE
Juncus_capitatus	NE
Juncus_cephalotes	LC
Juncus_dregeanus	LC
Juncus_effusus	LC
Juncus_imbricatus	NE
Juncus_krausii	NA
Juncus_lomatophyllus	LC
Juncus_oxycarpus	LC
Juncus_punctorius	LC
Juncus_rupestris	LC
Juncus_scabriusculus	LC
Juncus_stenopetalus	LC
Jussiaea_angustifolia	NA
Kedrostis_nana	LC
Kickxia_spuria	NE
Kiggelaria_africana	LC
Klattia_partita	NT
Kniphofia_tabularis	LC
Kniphofia_uvaria	LC
Knowltonia_anemonoides	LC
Knowltonia_capensis	LC
Knowltonia_vesicatoria	LC
Koeleria_capensis	LC
Lachenalia_aloides	LC
Lachenalia_bulbifera	LC
Lachenalia_capensis	VU
Lachenalia_contaminata	NT
Lachenalia_fistulosa	LC
Lachenalia_mediana	VU
Lachenalia_orchoides	NA
Lachenalia_pustulata	NT
Lachenalia_reflexa	VU
Lachenalia_rosea	LC
Lachenalia_rubida	LC
Lachenalia_salteri	EN
Lachenalia_unifolia	LC
Lachenalia_variegata	LC
Lachnaea_capitata	VU
Lachnaea_densiflora	NT
Lachnospermum_fasciculatum	LC
Lachnospermum_imbricatum	LC
Lactuca_capensis	LC
Lactuca_serriola	NE
Lagurus_ovatus	NE
Lamarckia_aurea	NE
Lampranthus_aduncus	DDT
Lampranthus_aurantiacus	LC
Lampranthus_austricolus	NA
Lampranthus_bicolor	VU
Lampranthus_caespitosus	DDT
Lampranthus_calcaratus	DDT
Lampranthus_curvifolius	VU
Lampranthus_dunensis	EN
Lampranthus_elegans	LC
Lampranthus_emarginatus	LC
Lampranthus_explanatus	EN
Lampranthus_falciformis	LC
Lampranthus_filicaulis	VU
Lampranthus_glaucus	VU
Lampranthus_incurvus	DDT
Lampranthus_multiradiatus	LC
Lampranthus_peacockiae	VU
Lampranthus_promontorii	Rare
Lampranthus_reptans	EN
Lampranthus_roseus	DDT
Lampranthus_spiniformis	LC
Lampranthus_steenbergensis	LC
Lampranthus_stenus	EN
Lampranthus_tenuifolius	CR
Lampranthus_tenuis	DDT
Lampranthus_variabilis	DDT
Lantana_camara	NE
Lapeirousia_anceps	LC
Lapeirousia_corymbosa	Declining
Lapeirousia_jacquinii	LC
Lapsana_communis	NA
Lasiopogon_brachypterus	LC
Lasiopogon_glomeratus	NA
Lasiospermum_bipinnatum	LC
Lathyrus_angulatus	NA
Lathyrus_cicera	NA
Lathyrus_culinaris	NA
Lathyrus_latifolius	NA
Laurembergia_repens	LC
Laurentia_arabidea	LC
Laurentia_pygmaea	LC
Laurentia_secunda	LC
Lavetera_arborea	NA
Lavetera_cretica	NA
Lebeckia_carnosa	NE
Lebeckia_inflata	LC
Lebeckia_macowanii	NE
Lebeckia_meyeriana	EN
Lebeckia_plukenetiana	EN
Lebeckia_wrightii	LC
Leidesia_procumbens	LC
Lemna_gibba	LC
Leonotis_leonuris	NA
Lepidium_africanum	LC
Lepidium_capense	LC
Lepidium_ecklonii	LC
Lepidium_pinnatum	LC
Lepidium_ruderale	NA
Lepidium_virginicum	NE
Leptospermum_laevigatum	NE
Lessertia_argentea	LC
Lessertia_capensis	LC
Lessertia_excisa	LC
Lessertia_herbacea	LC
Lessertia_miniata	LC
Lessertia_physodes	LC
Lessertia_tomentosa	LC
Leucadendron_argenteum	EN
Leucadendron_coniferum	VU
Leucadendron_floridum	CR
Leucadendron_grandiflorum	EX
Leucadendron_laureolum	LC
Leucadendron_levisanus	CR
Leucadendron_macowanii	CR
Leucadendron_rubrum	LC
Leucadendron_salicifolia	NA
Leucadendron_salignum	LC
Leucadendron_spissifolium	LC
Leucadendron_strobilinum	NT
Leucadendron_xanthoconus	LC
Leucospermum_conocarpodendron	EN
Leucospermum_cordifolium	NT
Leucospermum_hypophyllocarpodendr	NA
Leucospermum_reflexum	NE
Leucospermum_rodolentum	VU
Leucospermum_vestitum	NT
Leysera_gnaphalodes	LC
Lichtensteinia_lacera	LC
Lichtensteinia_obscura	LC
Lightfootia_adpressa	LC
Lightfootia_longifolia	DDT
Lightfootia_oppositifolia	LC
Lightfootia_parvifolia	LC
Lightfootia_subulata	VU
Lightfootia_tenella	LC
Lightfootia_tenuis	LC
Ligustrum_japonicum	NE
Ligustrum_sinense	NE
Limeum_africanum	LC
Limonium_equisetinum	LC
Limonium_perigrinum	NA
Limonium_scabrum	LC
Limonium_sinuatum	NE
Limosella_aquatica	NE
Limosella_grandiflora	LC
Linum_africanum	LC
Linum_quadrifolium	LC
Linum_thesioides	LC
Linum_thunbergii	LC
Liparia_angustifolia	EN
Liparia_graminifolia	EX
Liparia_laevigata	VU
Liparia_parva	VU
Liparia_splendens	LC
Liparis_capensis	LC
Lobelia_anceps	LC
Lobelia_boivini	NA
Lobelia_comosa	LC
Lobelia_coronopifolia	LC
Lobelia_eckloniana	Rare
Lobelia_erinus	LC
Lobelia_humifusa	NA
Lobelia_limosa	DDT
Lobelia_linearis	LC
Lobelia_pinifolia	LC
Lobelia_pubescens	LC
Lobelia_quadrisepela	NA
Lobelia_setacea	LC
Lobelia_zwartkopensis	CR_PE
Lobostemon_argenteus	LC
Lobostemon_fruticosus	LC
Lobostemon_glaber	LC
Lobostemon_glaucophyllus	LC
Lobostemon_montanus	LC
Lobostemon_paniculatus	LC
Lobostemon_trichotomus	LC
Lobularia_maritima	NE
Lolium_multiflorum	NE
Lolium_rigidum	NE
Lolium_temulentum	NE
Lotononis_fastigiata	LC
Lotononis_hirsuta	LC
Lotononis_involucrata	VU
Lotononis_oxyptera	LC
Lotononis_perplexa	DDD
Lotononis_prostrata	NT
Lotononis_sabulosa	LC
Lotononis_umbellata	LC
Lotus_angustissimus	NA
Lotus_subbiflorus	NE
Lotus_uliginosus	NE
Lupinus_micranthus	NA
Lychnis_flos-jovis	NA
Lycium_afrum	LC
Lycium_ferocissimum	LC
Lycopodiella_caroliniana	LC
Lycopodiella_cernua	LC
Lyperia_lychnidea	LC
Lyperia_tristis	LC
Lyperia_violacea	LC
Lythrum_hyssopifolia	NE
Lythrum_salicaria	NE
Macrostylis_villosa	EX
Mairia_burchellii	DDT
Mairia_coriacea	LC
Mairia_crenata	LC
Mairia_hybrid	NA
Malcomia_maritima	NA
Malva_nicaeensis	NA
Malva_parviflora	NE
Malva_verticillata	NE
Manochlamys_albicans	LC
Manulea_cheiranthus	LC
Manulea_tomentosa	LC
Mariscus_congestus	LC
Mariscus_thunbergii	LC
Marrubium_vulgare	NE
Marsilea_macrocarpa	LC
Mastersiella_digitata	LC
Matthiola_incana	NE
Maurocenia_frangularia	LC
Maytenus_acuminata	LC
Maytenus_angustifolia	LC
Maytenus_lucida	LC
Maytenus_oleoides	LC
Medicago_laciniata	NE
Medicago_minima	NA
Medicago_polymorpha	NE
Medicago_sativa	NE
Melasma_scabrum	LC
Melasphaerula_ramosa	LC
Melia_azedarach	NE
Melianthus_major	LC
Melica_racemosa	LC
Melilotus_alba	NA
Melilotus_indica	NA
Melinis_repens	LC
Melolobium_aethiopicum	LC
Melolobium_exudans	LC
Mentha_aquatica	LC
Mentha_longifolia	LC
Mentha_spicata	NE
Merciera_brevifolia	EN
Mercurialis_annua	NE
Merxmuellera_cincta	LC
Merxmuellera_decora	LC
Merxmuellera_disticha	LC
Merxmuellera_lupulina	LC
Merxmuellera_rufa	LC
Merxmuellera_stricta	LC
Mesembryanthemum_cristallinum	NA
Mesembryanthemum_nodiflorum	LC
Metalasia_brevifolia	LC
Metalasia_cephalotes	LC
Metalasia_compacta	LC
Metalasia_densa	LC
Metalasia_divergens	LC
Metalasia_muricata	LC
Metrosideros_angustifolia	LC
Metrosideros_excelsa	NA
Micranthus_alopecuroides	LC
Micranthus_junceus	LC
Micranthus_tubulosis	NA
Microcodon_glomeratum	LC
Microcodon_hispidulum	LC
Microcodon_sparsiflorum	LC
Microdon_capitatus	EN
Microdon_nitidus	Rare
Microloma_sagittatum	LC
Microloma_tenuifolium	LC
Mimetes_cucullatus	LC
Mimetes_fimbriifolius	Rare
Mimetes_hirtus	VU
Modiola_caroliana	NA
Moenchia_erecta	NE
Mohria_caffrorum	LC
Mollugo_pusilla	LC
Monadenia_atrorubens	VU
Monadenia_bolusiana	LC
Monadenia_bracteata	LC
Monadenia_cernua	VU
Monadenia_comosa	LC
Monadenia_conferta	LC
Monadenia_densiflora	LC
Monadenia_ecalcarata	DDD
Monadenia_ophrydea	LC
Monadenia_physodes	CR
Monadenia_pygmaea	Rare
Monadenia_reticulata	LC
Monadenia_rufescens	LC
Monadenia_sabulosa	CR
Monopsis_debilis	LC
Monopsis_lutea	LC
Monopsis_simplex	LC
Monopsis_variifolia	EN
Monsonia_emarginata	LC
Montinia_caryophyllacea	LC
Moraea_angusta	LC
Moraea_anomala	LC
Moraea_aristata	CR
Moraea_bellendenii	LC
Moraea_bituminosa	LC
Moraea_bulbillifera	LC
Moraea_ciliata	LC
Moraea_elsiae	VU
Moraea_flaccida	LC
Moraea_fugax	LC
Moraea_gawleri	LC
Moraea_inconspicua	LC
Moraea_lugubris	LC
Moraea_neglecta	LC
Moraea_papilionacea	LC
Moraea_ramosissima	LC
Moraea_tricolor	EN
Moraea_tricuspidata	LC
Moraea_tripetala	LC
Moraea_vegeta	LC
Moraea_viscaria	LC
Morella_cordifolia	LC
Muraltia_acipetala	Rare
Muraltia_alopecuroides	LC
Muraltia_brachypetala	VU
Muraltia_brevicornu	EN
Muraltia_comptonii	VU
Muraltia_curvipetala	Rare
Muraltia_demissa	LC
Muraltia_diabolica	Rare
Muraltia_dumosa	LC
Muraltia_ericoides	LC
Muraltia_filiformis	LC
Muraltia_heisteria	LC
Muraltia_hybrids	NA
Muraltia_macropetela	NA
Muraltia_mitior	EN
Muraltia_mixta	DDD
Muraltia_orbicularis	VU
Muraltia_pageae	LC
Muraltia_pauciflora	LC
Muraltia_rosmarinifolia	LC
Muraltia_satureioides	LC
Muraltia_serpylloides	LC
Muraltia_stipulacea	DDD
Muraltia_thunbergii	NT
Muraltia_thymifolia	LC
Myoporum_tenuifolium_subsp._montanum	NA
Myosotis_arvensis	NE
Myosotis_discolor	NE
Myrica_diversifolia	LC
Myrica_humilis	LC
Myrica_kraussiana	LC
Myrica_quercifolia	LC
Myrica_serrata	LC
Myriophyllum_aquaticum	NE
Myrsine_africana	LC
Myrsine_pillansii	LC
Myrtus_communis	NE
Nasella_trichotoma	NA
Neesenbeckia_punctoria	LC
Nemesia_barbata	LC
Nemesia_bicornis	LC
Nemesia_fruticans	LC
Nemesia_gracilis	LC
Nemesia_guthriei	LC
Nemesia_lucida	DDT
Nemesia_macrocarpa	LC
Nemesia_micrantha	EX
Nemesia_pinnata	LC
Nemesia_versicolor	LC
Nenax_acerosa	LC
Nenax_hirta	NT
Nephrolepis_exaltata	NE
Nerine_sarniensis	LC
Nerium_oleander	NE
Neslia_paniculata	NA
Nicandra_physolodes	NA
Nicotiana_glauca	NE
Nidorella_foetida	LC
Noltea_africana	LC
Noltea_nigrita	NA
Nothoscordum_gracile	NA
Nylandtia_spinosa	LC
Nymphaea_nounchali	NA
Nymphoides_indica	LC
Nymphoides_thunbergiana	LC
Ocotea_bullata	EN
Oedera_genistifolia	LC
Oedera_imbricata	LC
Oedera_prolifera	LC
Oedera_steyniae	VU
Oenothera_biennis	NE
Oenothera_longifolia	NA
Oenothera_nocturna	NA
Oenothera_odorata	NA
Oenothera_rosea	NE
Oenothera_striata	NA
Oftia_africana	LC
Oldenlandia_capensis	LC
Olea_capensis	LC
Olea_europaea	LC
Olea_exasperata	LC
Olinia_ventosa	LC
Oncosiphon_africanum	VU
Oncosiphon_grandiflorum	LC
Oncosiphon_sabulosum	LC
Oncosiphon_suffruticosum	LC
Onixotis_punctata	NA
Onixotis_stricta	LC
Ophioglossum_bergianum	Rare
Ophioglossum_nudicaule	LC
Ophioglossum_polyphyllum	LC
Opuntia_ficus-indica	NE
Opuntia_monacantha	NA
Orbea_variegata	LC
Orbea_verrucosa	LC
Ornithogalum_conicum	LC
Ornithogalum_dregeanum	LC
Ornithogalum_graminifolium	LC
Ornithogalum_hispidum	LC
Ornithogalum_juncifolium	Critically_Rare
Ornithogalum_niveum	NE
Ornithogalum_pilosum	LC
Ornithogalum_suaveolens	LC
Ornithogalum_thyrsoides	LC
Ornithoglossum_viride	LC
Ornithopus_compressus	NA
Orobanche_minor	NE
Orobanche_ramosa	NE
Orphium_frutescens	LC
Osmitopsis_asteriscoides	LC
Osmitopsis_dentata	Rare
Osmunda_regalis	LC
Osteospermum_ciliatum	LC
Osteospermum_clandestinum	LC
Osteospermum_dentatum	LC
Osteospermum_fruticosum	LC
Osteospermum_hyoseroides	LC
Osteospermum_imbricatum	LC
Osteospermum_polygaloides	LC
Osteospermum_spinosum	LC
Osteospermum_tomentosum	LC
Osyris_compressa	LC
Otholobium_bracteolatum	LC
Otholobium_decumbens	LC
Otholobium_fruticans	LC
Otholobium_hirtum	LC
Otholobium_spicatum	LC
Otholobium_trianthum	LC
Otholobium_uncinatum	NT
Othonna_amplexifolia	LC
Othonna_arborescens	LC
Othonna_bulbosa	LC
Othonna_ciliata	VU
Othonna_coronopifolia	LC
Othonna_dentata	LC
Othonna_digitata	LC
Othonna_filicaulis	LC
Othonna_heterophylla	LC
Othonna_parviflora	LC
Othonna_perfoliata	LC
Othonna_pinnata	LC
Othonna_quinquedentata	LC
Othonna_stenophylla	LC
Oxalis_argyrophylla	LC
Oxalis_bifida	LC
Oxalis_caprina	LC
Oxalis_commutata	LC
Oxalis_compressa	LC
Oxalis_corniculata	NE
Oxalis_dentata	LC
Oxalis_depressa	LC
Oxalis_eckloniana	LC
Oxalis_falcatula	EN
Oxalis_flava	LC
Oxalis_glabra	LC
Oxalis_hirta	DDT
Oxalis_incarnata	LC
Oxalis_lanata	LC
Oxalis_latifolia	NE
Oxalis_luteola	LC
Oxalis_minuta	LC
Oxalis_monophylla	LC
Oxalis_multicaulis	LC
Oxalis_natans	CR
Oxalis_nidulans	LC
Oxalis_obtusa	LC
Oxalis_pes-caprae	LC
Oxalis_pocockiae	LC
Oxalis_polyphylla	LC
Oxalis_punctata	LC
Oxalis_purpurea	LC
Oxalis_pusilla	LC
Oxalis_stellata	LC
Oxalis_tenuifolia	LC
Oxalis_tomentosa	LC
Oxalis_versicolor	LC
Pachites_bodkinii	Rare
Panicum_coloratum	LC
Panicum_maximum	LC
Panicum_obumbratum	LC
Panicum_repens	LC
Panicum_schinzii	LC
Panicum_subalbidum	LC
Paraserianthes_lophantha	NE
Paronychia_braziliana	NA
Paspalum_dictichum	NA
Paspalum_dilatatum	NE
Paspalum_urvillei	NE
Paspalum_vaginatum	LC
Passerina_ericoides	VU
Passerina_filiformis	LC
Passerina_paleacea	LC
Passerina_paludosa	EN
Passerina_rigida	LC
Passerina_vulgaris	LC
Passiflora_caerulea	NA
Pauridia_minuta	NT
Pavonia_columella	LC
Pelargonium_alchemilloides	LC
Pelargonium_anethifolium	LC
Pelargonium_auritum	LC
Pelargonium_betulinum	LC
Pelargonium_candicans	LC
Pelargonium_capitatum	LC
Pelargonium_chamaedrifolium	NA
Pelargonium_cucullatum	LC
Pelargonium_ellaphieae	EN
Pelargonium_elongatum	LC
Pelargonium_gibbosum	LC
Pelargonium_grossulariodes	NA
Pelargonium_hirtum	LC
Pelargonium_hybrids	NA
Pelargonium_iocastum	LC
Pelargonium_lobatum	LC
Pelargonium_longifolium	LC
Pelargonium_multiradiatum	LC
Pelargonium_myrrhifolium	LC
Pelargonium_pillansii	LC
Pelargonium_pinnatum	LC
Pelargonium_plurisectum	VU
Pelargonium_radens	LC
Pelargonium_rapaceum	LC
Pelargonium_revolutum	EN
Pelargonium_senecioides	LC
Pelargonium_tabulare	LC
Pelargonium_triste	LC
Pelargonium_vitifolium	LC
Pellaea_calomelanos	LC
Pellaea_pteroides	LC
Penaea_mucronata	LC
Pennisetum_clandestinum	NE
Pennisetum_macrourum	LC
Pennisetum_setaceum	NE
Pennisetum_thunbergii	LC
Pentameris_longiglumis	Rare
Pentameris_macrocalycina	LC
Pentaschistis_acinosa	LC
Pentaschistis_airoides	LC
Pentaschistis_ampla	LC
Pentaschistis_argentea	LC
Pentaschistis_aristidoides	LC
Pentaschistis_aspera	NT
Pentaschistis_aurea	LC
Pentaschistis_barbata	LC
Pentaschistis_capensis	LC
Pentaschistis_colorata	LC
Pentaschistis_curvifolia	LC
Pentaschistis_ecklonii	EN
Pentaschistis_eriostoma	LC
Pentaschistis_glandulosa	LC
Pentaschistis_malouinensis	LC
Pentaschistis_pallescens	LC
Pentaschistis_pallida	LC
Pentaschistis_papillosa	LC
Pentaschistis_pusilla	LC
Pentaschistis_rigidissima	LC
Pentaschistis_tortuosa	LC
Peperomia_retusa	LC
Periballia_minuta	NE
Persea_americana	NA
Persicaria_attenuata	LC
Persicaria_lapathifolium	NA
Persicaria_serrulata	LC
Petalacte_coronata	LC
Petrorhagia_prolifera	NE
Peucedanum_capense	NA
Peucedanum_ferulaceum	NA
Peucedanum_galbaniopse	NA
Peucedanum_galbanum	NA
Peucedanum_gummiferum	NA
Peucedanum_hybrid	NA
Peucedanum_sieberianum	NA
Peucedanum_strictum	NA
Phaenocoma_prolifera	LC
Phalaris_angusta	NE
Phalaris_aquatica	NE
Phalaris_minor	NE
Pharnaceum_cordifolium	LC
Pharnaceum_dichotomum	LC
Pharnaceum_elongatum	LC
Pharnaceum_exiguum	LC
Pharnaceum_lanatum	LC
Pharnaceum_lineare	LC
Phoenix_canariensis	NA
Phragmitis_australis	NA
Phyla_nodiflora	NE
Phylica_atrata	LC
Phylica_buxifolia	LC
Phylica_callosa	LC
Phylica_cephalantha	LC
Phylica_dioica	LC
Phylica_disticha	LC
Phylica_dodii	LC
Phylica_ericoides	LC
Phylica_excelsa	LC
Phylica_harveyi	VU
Phylica_imberbis	LC
Phylica_parviflora	LC
Phylica_plumosa	VU
Phylica_pubescens	LC
Phylica_schlechterii	NA
Phylica_stipularis	LC
Phylica_strigosa	LC
Phylica_villosa	LC
Phyllobolus_canaliculatus	LC
Phyllopodium_capillare	NT
Phyllopodium_capitatatum	NA
Phyllopodium_cordatum	LC
Phyllopodium_heterophyllum	LC
Physalis_peruviana	NE
Phytolacca_americana	NE
Phytolacca_octandra	NE
Picris_echioides	NE
Pinus_canariensis	NE
Pinus_halipensis	NA
Pinus_pinaster	NE
Pinus_pinea	NE
Pinus_radiata	NE
Pistia_stratoites	NA
Pittosporum_undulatum	NE
Plantago_bigelovii	NE
Plantago_coronopus	NE
Plantago_crassifolia	LC
Plantago_lanceolata	LC
Plantago_remota	LC
Platycaulos_compressus	LC
Platycaulos_major	LC
Plecostachys_polifolia	LC
Plecostachys_serpyllifolia	LC
Plectranthus_comosus	NA
Pleopeltis_macrocarpa	LC
Plexipus_cernuus	LC
Poa_annua	NE
Poa_pratensis	NE
Podalyria_argentea	EN
Podalyria_biflora	LC
Podalyria_calyptrata	LC
Podalyria_cuneifolia	LC
Podalyria_sericea	NT
Podocarpus_latifolius	LC
Polpoda_capensis	LC
Polyarrhena_reflexa	VU
Polycarena_capensis	NT
Polycarena_cephalophora	LC
Polycarena_silenoides	CR_PE
Polycarpon_tetraphyllum	NA
Polygala_bracteolata	LC
Polygala_garcini	NA
Polygala_lehmanniana	LC
Polygala_myrtifolia	LC
Polygala_nematocaulis	LC
Polygala_recognita	LC
Polygala_refracta	LC
Polygala_virgata	LC
Polygonum_aviculare	NE
Polygonum_maritimum	NE
Polygonum_undulatum	LC
Polypogon_maritimus	NA
Polypogon_monspeliensis	NE
Polypogon_strictus	LC
Polypogon_viridis	NE
Polystichum_monticola	LC
Polystichum_pungens	LC
Polyxena_corymbosa	NA
Populus_canescens	NA
Portulaca_oleracea	NE
Potamogeton_pectinatus	LC
Potamogeton_pusillus	LC
Prenia_pallens	LC
Printzia_aromatica	LC
Printzia_polifolia	LC
Prionanthium_pholiuroides	EN
Prionium_serratum	Declining
Prismatocarpus_fruticosus	LC
Prismatocarpus_nitidus	LC
Prismatocarpus_sessilis	DDT
Protea_acaulos	LC
Protea_aurea	LC
Protea_burchellii	VU
Protea_compacta	NT
Protea_coronata	NT
Protea_cynaroides	LC
Protea_eximia	LC
Protea_grandiceps	NT
Protea_laurifolia	LC
Protea_lepidocarpodendron	NT
Protea_magnifica	LC
Protea_neriifolia	LC
Protea_nitida	LC
Protea_repens	LC
Protea_scolymocephala	VU
Protea_scorzonerifolia	VU
Protea_speciosa	LC
Protea_susannae	NT
Pseudalthenia_aschersoniana	CR
Pseudobaeckia_africana	NA
Pseudognaphalium_luteo_-_album	NA
Pseudognaphalium_undulatum	LC
Pseudopentameris_macrantha	LC
Pseudoselago_peninsulae	DDD
Psidium_guajava	NE
Psilocaulon_parviflorum	LC
Psoralea_aculeata	LC
Psoralea_alata	LC
Psoralea_aphylla	LC
Psoralea_asarina	NT
Psoralea_capitata	LC
Psoralea_cordata	LC
Psoralea_fascicularis	EN
Psoralea_glaucina	CR
Psoralea_hybrids	NA
Psoralea_imbricata	LC
Psoralea_laxa	LC
Psoralea_pinnata	LC
Psoralea_repens	NT
Psoralea_restioides	LC
Psoralea_spicata	LC
Pteridium_aquilinum	LC
Pteris_dentata	LC
Pteris_tremula	NE
Pteris_vittata	LC
Pterocelastrus_rostratus	Declining
Pterocelastrus_tricuspidatus	LC
Pteronia_camphorata	LC
Pteronia_hirsuta	LC
Pteronia_uncinata	LC
Pterygodium_acutifolium	LC
Pterygodium_alatum	LC
Pterygodium_caffrum	LC
Pterygodium_catholicum	LC
Pterygodium_connivens	CR_PE
Pterygodium_cruciferum	EN
Pterygodium_platypetalum	LC
Pterygodium_volucris	LC
Puccinellia_fasciculata	NE
Pulicaria_scabra	LC
Putterlickia_pyracantha	LC
Pycreus_mundii	LC
Pycreus_nitidus	LC
Pycreus_polystachyos	LC
Pyracantha_angustifolia	NE
Pyracantha_coccinea	NE
Quercus_canariensis	NA
Quercus_cerris	NA
Quercus_ilex	NA
Quercus_palustris	NA
Quercus_robur	NE
Quercus_suber	NA
Rafnia_angulata	LC
Rafnia_capensis	LC
Rafnia_crassifolia	LC
Rafnia_triflora	LC
Ranunculus_multifidus	NE
Ranunculus_muricatus	NE
Ranunculus_trichophyllus	LC
Rapanea_melanophloeos	Declining
Raphanus_raphanistrum	NE
Raphanus_sativus	NE
Rapistrum_rugosum	NE
Relhania_fruticosa	LC
Reseda_alba	NA
Reseda_lutea	LC
Restio_ambiguus	LC
Restio_bifidus	LC
Restio_bifurcus	LC
Restio_communis	VU
Restio_dispar	LC
Restio_distichus	LC
Restio_dodii	VU
Restio_egregius	LC
Restio_filiformis	LC
Restio_harveyi	EN
Restio_leptostachyus	LC
Restio_micans	EN
Restio_multiflorus	LC
Restio_pedicillatus	NA
Restio_perplexus	LC
Restio_quadratus	LC
Restio_quinquefarius	LC
Restio_sarcocladus	NA
Restio_sejunctus	LC
Restio_tetragonus	LC
Restio_triticeus	LC
Restio_versatilis	LC
Rhodocoma_fruticosa	LC
Rhoicissus_tomentosa	LC
Rhus_hybrids	NA
Rhynchopsidium_sessiliflora	NA
Rhynchosia_capensis	LC
Rhynchosia_ferulifolia	LC
Rhynchosia_pinnata	LC
Rhynchospora_brownii	LC
Ricinus_communis	NE
Robinia_pseudoacacia	NE
Roella_amplexicaulis	LC
Roella_ciliata	LC
Roella_compacta	LC
Roella_decurrens	VU
Roella_dunantii	LC
Roella_goodiana	VU
Roella_muscosa	LC
Roella_prostrata	LC
Roella_recurvata	Rare
Roella_squarrosa	LC
Roella_triflora	LC
Roepera_flexuosum	NA
Roepera_fulvum	NA
Roepera_morgsana	NA
Roepera_procumbens	NA
Roepera_sessilifolium	NA
Roepera_spinosum	NA
Romulea_cruciata	LC
Romulea_flava	LC
Romulea_gracillima	LC
Romulea_hirsuta	LC
Romulea_minutiflora	LC
Romulea_obscura	LC
Romulea_papyracea	LC
Romulea_rosea	LC
Romulea_schlechteri	LC
Romulea_tabularis	LC
Romulea_triflora	LC
Rorippa_officinale	NA
Rubus_fruiticosus	NA
Rubus_pinnatus	LC
Rubus_rigidus	LC
Rubus_rosifolius	NE
Rumex_acetosella	NE
Rumex_conglomeratus	LC
Rumex_cordatus	LC
Rumex_crispus	NE
Rumex_lanceolatus	LC
Rumex_lativalvis	LC
Rumex_pulcher	NE
Rumex_saggitatus	NA
Rumohra_adiantiformis	LC
Ruppia_cirrhosa	LC
Ruppia_maritima	LC
Ruppia_spiralis	LC
Ruschia_filamentosa	Rare
Ruschia_geminiflora	VU
Ruschia_macowanii	LC
Ruschia_microphylla	DDT
Ruschia_promontorii	Rare
Ruschia_pulchella	NA
Ruschia_rubricaulis	VU
Ruschia_rupis_-_arcuatae	NA
Ruschia_sarmentosa	LC
Sagina_apetala	NE
Sagina_maritima	NE
Sagina_procumbens	NA
Salaxis_axillaris	LC
Salicornia_meyeriana	LC
Salix_babylonica	NE
Salix_caprea	NE
Salix_mucronata	NE
Salsola_kali	NE
Saltera_sarcocolla	LC
Salvia_africana_-_caerulea	NA
Salvia_africana_-_lutea	NA
Salvia_chamelaeagnea	LC
Salvia_lanceolata	LC
Salvinia_molesta	NE
Samolus_porosus	LC
Samolus_valerandi	LC
Sanicula_elata	LC
Sarcocornia_capensis	LC
Sarcocornia_littorea	LC
Sarcocornia_natalensis	LC
Sarcocornia_perennis	LC
Sarcocornia_pillansii	LC
Satyridium_rostratum	LC
Satyrium_bicallosum	LC
Satyrium_bicorne	LC
Satyrium_bracteatum	LC
Satyrium_candidum	LC
Satyrium_carneum	NT
Satyrium_coriifolium	LC
Satyrium_erectum	LC
Satyrium_foliosum	VU
Satyrium_halackii	NA
Satyrium_humile	LC
Satyrium_ligulatum	LC
Satyrium_lupulinum	LC
Satyrium_odorum	LC
Satyrium_retusum	LC
Satyrium_stenopetalum	LC
Satyrium_striatum	VU
Scabiosa_africana	LC
Scabiosa_angustiloba	LC
Scabiosa_columbaria	LC
Schinus_molle	NE
Schinus_terebinthefolius	NA
Schizaea_pectinata	LC
Schizaea_tenella	LC
Schizodium_bifidum	NA
Schizodium_cornutum	NA
Schizodium_flexuosum	NA
Schizodium_inflexum	NA
Schizodium_obliquum	NA
Schizoglossum_aschersonianum	LC
Schizoglossum_periglossoides	LC
Schkuhria_pinnata	NE
Schoenoplectus_scirpioides	NA
Schoenoplectus_triqueter	NE
Schoenoxiphium_ecklonii	LC
Schoenoxiphium_lanceum	LC
Schoenoxiphium_lehmanii	NA
Schoenoxiphium_sparteum	LC
Schoenoxiphium_thunbergii	LC
Schoenus_nigricans	LC
Scirpoides_nodosus	LC
Scirpoides_thunbergii	LC
Scirpus_delicatulus	EX
Scirpus_diabolicus	LC
Scirpus_fluitans	LC
Scirpus_globiceps	LC
Scirpus_maritimus	LC
Scirpus_radosus	NA
Scirpus_trachyspermus	LC
Scleranthus_annuus	NE
Scolopia_mundii	LC
Scopologena_veruculata	NA
Scutia_myrtina	LC
Scyphogyne_muscosa	LC
Scyphogyne_urceolata	LC
Sebaea_albens	LC
Sebaea_ambigua	LC
Sebaea_aurea	LC
Sebaea_capitata	LC
Sebaea_exacoides	LC
Sebaea_hybrid	NA
Sebaea_micrantha	LC
Sebaea_minutiflora	LC
Sebaea_pusilla	LC
Sebaea_schlechteri	LC
Sebaea_sulphurea	LC
Sebaea_zeyherii	NA
Secale_cereale	NA
Secamone_alpini	LC
Secamone_filiformis	LC
Selaginella_pygmaea	LC
Selago_adpressa	LC
Selago_corymbosa	LC
Selago_cylidrica	NA
Selago_dregei	VU
Selago_fruticulosa	LC
Selago_quadrangularis	Rare
Selago_scabrida	LC
Selago_serrata	LC
Selago_spuria	LC
Senecio_abruptus	LC
Senecio_aloides	LC
Senecio_angulatus	LC
Senecio_arenarius	LC
Senecio_arniciflorus	LC
Senecio_bipinnatus	LC
Senecio_burchellii	LC
Senecio_carroensis	LC
Senecio_cordifolius	LC
Senecio_corymbiferus	LC
Senecio_crassulifolius	NA
Senecio_crenulatus	DDT
Senecio_crispus	LC
Senecio_cymbalariifolius	LC
Senecio_elegans	LC
Senecio_erosus	LC
Senecio_erubescens	LC
Senecio_foeniculiodes	NA
Senecio_glastifolius	LC
Senecio_glutinaruis	NA
Senecio_grandiflorus	LC
Senecio_halimifolius	LC
Senecio_hastutus	NA
Senecio_hybrid	NA
Senecio_laevigatus	LC
Senecio_lanceus	LC
Senecio_lineatus	LC
Senecio_littoreus	LC
Senecio_lyratus	NE
Senecio_maritimus	LC
Senecio_paniculatus	LC
Senecio_pillansii	Thr*
Senecio_pinifolius	LC
Senecio_pinnulatus	LC
Senecio_pterophorus	LC
Senecio_pubigerus	LC
Senecio_purpureus	LC
Senecio_repandus	LC
Senecio_rigidus	LC
Senecio_rosmarinifolius	LC
Senecio_scapiflorus	LC
Senecio_speciosus	LC
Senecio_subcanescens	LC
Senecio_tamoides	LC
Senecio_triqueter	LC
Senecio_umbellatus	LC
Senecio_verbascifolius	EN
Senecio_vulgaris	NE
Senna_multiglandulosa	NE
Serruria_aemula	CR
Serruria_collina	VU
Serruria_cyanoides	EN
Serruria_decumbens	EN
Serruria_fasciflora	NT
Serruria_foeniculacea	CR
Serruria_glomerata	VU
Serruria_hirsuta	CR
Serruria_inconspicua	VU
Serruria_trilopha	CR
Serruria_villosa	Rare
Sesamum_capense	LC
Sesbania_punicea	NE
Seseli_annuum	NA
Setaria_geniculata	NE
Setaria_megaphylla	LC
Setaria_sphacelata	LC
Setaria_verticillata	LC
Setaria_viridis	NA
Sida_rhombifolia	LC
Sideroxylon_inerme	LC
Siersia_angustifolia	NA
Siersia_crenata	NA
Siersia_dissecta	NA
Siersia_glauca	NA
Siersia_laevigata	NA
Siersia_lucida	NA
Siersia_rosmarinifolia	NA
Siersia_scytophylla	NA
Siersia_tomentosa	NA
Siersia_undulata	NA
Silene_belladoides	NA
Silene_burchellii	NE
Silene_clandestina	NE
Silene_crassifolia	LC
Silene_gallica	NE
Silene_undulata	LC
Silybum_marianum	NE
Simocheilus_bicolor	LC
Simocheilus_depressus	LC
Simocheilus_purpureus	LC
Sinapis_alba	NE
Sinapis_arvensis	NE
Sisymbrium_capense	LC
Sisymbrium_officinale	NE
Sisymbrium_orientale	NE
Sisyrinchium_micranthum	NE
Skiatophytum_tripolium	VU
Solanum_aculeastrum	LC
Solanum_americanum	NE
Solanum_burbankii	LC
Solanum_giganteum	LC
Solanum_guineense	LC
Solanum_hermannii	LC
Solanum_linnaeanum	LC
Solanum_marginatum	NA
Solanum_mauritianum	NE
Solanum_nigrum	NE
Solanum_pseudocapsicum	NE
Solanum_retroflexum	LC
Solanum_sisymbriifolium	NE
Solanum_tomentosum	LC
Soliva_pterosperma	NE
Sonchus_asper	NE
Sonchus_dregeanus	LC
Sonchus_oleraceus	NE
Sonderina_didyma	LC
Sonderina_hispida	LC
Sparaxis_bulbifera	LC
Sparaxis_grandiflora	LC
Sparaxis_villosa	LC
Spartium_junceum	NE
Spergula_arvensis	NE
Spergularia_macrorhiza	NA
Spergularia_marina	NA
Spergularia_media	NE
Spergularia_rubra	NE
Sphaerocionium_marlothii	NA
Spiloxene_alba	VU
Spiloxene_aquatica	LC
Spiloxene_canaliculata	EN
Spiloxene_capensis	LC
Spiloxene_curculigoides	LC
Spiloxene_flaccida	LC
Spiloxene_gracilipes	LC
Spiloxene_minuta	EN
Spiloxene_ovata	LC
Spiloxene_schlechteri	LC
Spiloxene_serrata	LC
Spirodela_punctata	LC
Sporobolus_africanus	LC
Sporobolus_virginicus	LC
Staavia_dodii	Rare
Staavia_dregeana	NA
Staavia_glutinosa	Rare
Staavia_radiata	LC
Staberoha_banksii	LC
Staberoha_cernua	LC
Staberoha_distachyos	LC
Staberoha_vaginata	LC
Stachys_aethiopica	LC
Stachys_arvensis	NE
Stachys_thunbergii	LC
Steirodiscus_tagetes	VU
Stellaria_media	NE
Stenocarpus_sinuatus	NA
Stenogramma_pozoi	NA
Stenotaphrum_secundatum	LC
Stilbe_ericoides	LC
Stilbe_vestita	LC
Stipa_dregeana	LC
Stipa_papposa	NA
Stipagrostis_anomala	LC
Stipagrostis_zeyheri	LC
Stoebe_aethiopica	LC
Stoebe_bruniades	LC
Stoebe_capitata	LC
Stoebe_cinerea	LC
Stoebe_fusca	LC
Stoebe_incana	DDT
Stoebe_plumosa	LC
Stoebe_prostrata	LC
Stoebe_rosea	Rare
Stoebe_sphaerocephala	LC
Strumaria_tenella	LC
Struthiola_ciliata	LC
Struthiola_confusa	LC
Struthiola_dodecandra	LC
Struthiola_hybrids	NA
Struthiola_myrsinites	LC
Struthiola_salteri	LC
Struthiola_striata	LC
Stylapterus_fruticulosus	EN
Suaeda_caespitosa	LC
Sutera_caerulea	LC
Sutera_hispida	LC
Sutera_pedunculata	LC
Sutera_uncinata	LC
Sutherlandia_frutescens	LC
Sympieza_gracilis	LC
Sympieza_labialis	LC
Syncarpha_canescens	LC
Syncarpha_gnaphaloides	LC
Syncarpha_speciosissima	LC
Syncarpha_variegata	LC
Syncarpha_vestita	LC
Syncarpha_zeyheri	Rare
Syndesmanthus_articulatus	LC
Syzygium_paniculatum	NA
Tagetes_minuta	NE
Taraxacum_officinale	NE
Tarchonanthus_camphoratus	LC
Teedia_lucida	LC
Tephrosia_capensis	LC
Tephrosia_grandiflora	LC
Tetragonia_decumbens	LC
Tetragonia_fruiticosa	NA
Tetragonia_herbacea	LC
Tetragonia_portulacoides	LC
Tetragonia_spicata	LC
Tetraria_autumnalis	LC
Tetraria_bolusii	LC
Tetraria_brachyphylla	NT
Tetraria_brevicaulis	NA
Tetraria_bromoides	LC
Tetraria_burmanii	NA
Tetraria_capillacea	LC
Tetraria_compacta	DDT
Tetraria_compar	LC
Tetraria_crassa	DDT
Tetraria_crinifolia	LC
Tetraria_cuspidata	LC
Tetraria_exilis	DDT
Tetraria_eximia	LC
Tetraria_fasciata	LC
Tetraria_fimbriolata	LC
Tetraria_flexuosa	LC
Tetraria_graminifolia	VU
Tetraria_involucrata	LC
Tetraria_macowaniana	LC
Tetraria_microstachys	LC
Tetraria_paludosa	CR_PE
Tetraria_pillansii	LC
Tetraria_pygmaea	LC
Tetraria_sylvatica	LC
Tetraria_thermalis	LC
Tetraria_triangularis	LC
Tetraria_ustulata	LC
Tetraria_variabilis	DDT
Thamnochortus_arenarius	LC
Thamnochortus_erectus	LC
Thamnochortus_fraternus	NT
Thamnochortus_fruticosus	LC
Thamnochortus_gracilis	LC
Thamnochortus_guthrieae	LC
Thamnochortus_levynsiae	Rare
Thamnochortus_lucens	LC
Thamnochortus_nutans	VU
Thamnochortus_obtusus	LC
Thamnochortus_punctatus	Declining
Thamnochortus_spicigerus	LC
Thamnochortus_sporadicus	LC
Thelypteris_confluens	LC
Themeda_triandra	LC
Thereianthus_bracteolatus	LC
Thereianthus_spicatus	LC
Thesidium_fragile	LC
Thesidium_fruticulosum	LC
Thesidium_hirtum	LC
Thesium_acuminatum	LC
Thesium_aggregatum	LC
Thesium_capitatum	LC
Thesium_capituliflorum	LC
Thesium_carinatum	NA
Thesium_commutatum	LC
Thesium_densiflorum	LC
Thesium_ecklonianum	EN
Thesium_ericifolium	NA
Thesium_euphrasioides	LC
Thesium_frisea	NA
Thesium_funale	LC
Thesium_nigromontanum	LC
Thesium_paniculatum	LC
Thesium_patulum	LC
Thesium_pinifolium	LC
Thesium_pseudovirgatum	LC
Thesium_pubescens	LC
Thesium_rariflorum	DDT
Thesium_scabrum	LC
Thesium_schumannianum	DDD
Thesium_sedifolium	NA
Thesium_spicatum	LC
Thesium_spinosum	LC
Thesium_spinulosum	LC
Thesium_strictum	LC
Thesium_virgatum	LC
Thesium_viridifolium	LC
Thinopyrum_distichum	NE
Todea_barbara	LC
Tolpis_capensis	LC
Torilis_arvensis	NE
Trachyandra_brachypoda	LC
Trachyandra_chlamydophylla	LC
Trachyandra_ciliata	LC
Trachyandra_divaricata	LC
Trachyandra_filiformis	LC
Trachyandra_flexifolia	LC
Trachyandra_hirsuta	LC
Trachyandra_hirsutiflora	LC
Trachyandra_hispida	LC
Trachyandra_muricata	LC
Trachyandra_revoluta	LC
Trachyandra_sabulosa	LC
Trachyandra_scabra	LC
Trachyandra_tabularis	LC
Tradescantia_fluminensis	NE
Tragus_koelerioides	LC
Treichelia_longebracteata	NA
Trianoptiles_capensis	LC
Trianoptiles_solitaria	CR
Trianoptiles_stipitata	LC
Tribolium_acutiflorum	LC
Tribolium_echinatum	LC
Tribolium_hispidum	LC
Tribolium_obliterum	LC
Tribolium_obtusifolium	LC
Tribolium_uniolae	LC
Tribulis_terrestris	NA
Trichogyne_ambigua	LC
Trichogyne_repens	LC
Trichogyne_verticillata	LC
Trifolium_angustifolium	NE
Trifolium_arvense	NE
Trifolium_burchellianum	LC
Trifolium_campestre	NE
Trifolium_cernuum	NE
Trifolium_dubium	NE
Trifolium_glomeratum	NE
Trifolium_ornithopodiodes	NA
Trifolium_repens	NE
Trifolium_resupinatum	NE
Trifolium_stipulaceum	LC
Trifolium_suffocatum	NE
Trifolium_tomentosum	NE
Triglochin_bulbosa	LC
Triglochin_striatum	NA
Triticum_durum	NA
Tritonia_crispa	LC
Tritonia_crocata	LC
Tritonia_duesta	NA
Tritonia_lineata	SA
Tritoniopsis_antholyza	LC
Tritoniopsis_dodii	LC
Tritoniopsis_parviflora	LC
Tritoniopsis_triticea	LC
Tritoniopsis_unguicularis	LC
Troglophyton_capillaceum	LC
Troglophyton_parvulum	LC
Tropaeolum_majus	NA
Tulbaghia_alliacea	LC
Tulbaghia_capensis	LC
Tylecodon_grandiflorus	LC
Tylecodon_paniculatus	LC
Typha_capensis	LC
Typha_domingensis	NA
Urospermum_picroides	NE
Ursinia_anthemoides	LC
Ursinia_chrysanthemoides	LC
Ursinia_dentata	LC
Ursinia_nana	LC
Ursinia_nudicaulis	LC
Ursinia_paleacea	LC
Ursinia_tenuifolia	LC
Urtica_dubia	NA
Urtica_urens	NE
Utricularia_bisquamata	LC
Valeriana_capensis	LC
Vellereophyton_dealbatum	LC
Verbascum_virgatum	NE
Verbena_bonariensis	NE
Verbena_litoralis	NE
Verbena_officinalis	NE
Verbena_venosa	NE
Vernonia_neocorymbosa	NA
Veronica_anagallis-aquatica	LC
Veronica_arvensis	NE
Veronica_persica	NE
Vicia_benghalensis	NE
Vicia_hirsuta	NE
Vicia_lutea	NA
Vicia_sativa	NE
Vicia_tetrasperma	NE
Vicia_villosa	NE
Villarsia_capensis	LC
Villarsia_goldblattiana	VU
Vinca_major	NE
Viola_arvensis	NE
Viola_decumbens	LC
Viola_tricolor	NE
Virgilia_divaricata	LC
Virgilia_oroboides	LC
Viscum_capense	LC
Viscum_rotundifolium	LC
Vittaria_isoetifolia	LC
Vulpia_bromoides	NE
Vulpia_fasciculata	NE
Vulpia_myuros	NE
Wachendorfia_brachyandra	VU
Wachendorfia_multiflora	LC
Wachendorfia_paniculata	LC
Wachendorfia_thyrsiflora	LC
Wahlenbergia_androsacea	LC
Wahlenbergia_annularis	LC
Wahlenbergia_brehmeri	DDD
Wahlenbergia_capensis	LC
Wahlenbergia_cernua	LC
Wahlenbergia_ciliolata	LC
Wahlenbergia_clavata	LC
Wahlenbergia_dunantii	DDT
Wahlenbergia_exilis	LC
Wahlenbergia_obovata	LC
Wahlenbergia_procumbens	LC
Wahlenbergia_pyrophila	LC
Wahlenbergia_rotundifolia	DDD
Wahlenbergia_saxifragoides	DDT
Wahlenbergia_subpilosa	DDT
Walafrida_pubescens	LC
Watsonia_angusta	LC
Watsonia_borbonica	VU
Watsonia_marginata	LC
Watsonia_meriana	LC
Watsonia_tabularis	LC
Watsonia_zeyheri	LC
Wiborgia_obcordata	LC
Widdringtonia_nodiflora	LC
Willdenowia_affinis	EX
Willdenowia_glomerata	LC
Willdenowia_humilis	LC
Willdenowia_incurvata	LC
Willdenowia_sulcata	LC
Willdenowia_teres	LC
Wimmerella_bifida	DDD
Withania_somnifera	LC
Witsenia_maura	Declining
Wolffia_arrhiza	LC
Wurmbea_hiemalis	VU
Wurmbea_inusta	VU
Wurmbea_marginata	LC
Wurmbea_monopetala	LC
Wurmbea_spicata	LC
Xanthium_spinosum	NE
Xanthium_strumarium	NE
Xiphotheca_fruticosa	VU
Xiphotheca_lanceolata	EN
Xiphotheca_reflexa	EN
Xyris_capensis	LC
Xysmalobium_undulatum	LC
Yucca_gloriosa	NA
Zaluzianskya_capensis	LC
Zaluzianskya_divaricata	LC
Zaluzianskya_ramosa	LC
Zaluzianskya_villosa	LC
Zannichellia_palustris	LC
Zantedeschia_aethiopica	LC
Zehneria_scabra	LC
Zostera_capensis	LC
Zyrphelis_capensis	NA
Zyrphelis_foliosa	LC
Zyrphelis_microcephala	LC
Zyrphelis_taxifolia	Rare
